0000000000000000022200000
0000000000000000022200000
0000000000000000022220000
0000000000000000022220000
0000000000000000002220000
0000000000000000002220000
0000000000000000002220000
0000000000011100002222000
0000000000111110002222000
0000000001111111000222000
0000000001111111000222000
0000000000111110000222000
0000000000011100000222000
0000000000000000002222000
0000000000000000002222000
0000000000000000022220000
0000000000000000022220000
0000000000000000022200000
0000000000000000022200000
0000000000000000022220000